 1111111111111111111111
 1C00000000000100C00001
 1000000000000000000001
111101110000111100C0001
1E000000001111000000011
1111111100011100P00001
1C00000000000100000001
1000000000000100000001
1101110000111100000001
10000000000C00000C0001
1111111111111111111111
