1111111111111111111111111111111111
1000000000000000000000000000000001
1010010100100000101001000000010101
1C10010010101010001001000000010101
1000000P00000000000000000000000001
1111111111111111111111111111111111
